NO ./assets/textures/yellow.png
SO ./assets/textures/red.png
WE ./assets/textures/brown.png
EA ./assets/textures/grey.png

F 220,100,0
C 225,30,0

1111111
1000001
1000001
1001001
10N0001
1111111