NO ./assets/textures/north.png
SO ./assets/textures/south.png
WE ./assets/textures/west.png
EA ./assets/textures/east.png

F 220,100,0
C

1111111
1000001
1000001
1000001
1000001
1000001
1000001
100N001
1111111