NO ./assets/textures/north.png
SO ./assets/textures/south.png
WE ./assets/textures/west.png
EA ./assets/textures/east.png

F 220,100,0
C 225,30,  00000000111

1111111
1000001
1000001
1001001
1000001
1000001
100N001
1110111
1110111
1110111
1110111
1110111
1110111
1110111
1110111
1110111
1110111
1110111
1110111
1110111
1110111
1110111
1110111
1110111
1110111
1110111
1110111
1110111
1110111
1110111
1110111
1111111
1111111
1111111
1111111
1111111
1111111
1111111
1111111
1111111
1111111
1111111
1111111
1111111
1111111
1111111
1111111
1111111
1111111
1111111
1111111
1111111
1111111
1111111
1111111
1111111
1111111
1111111
1111111
1111111
1111111
1111111
1111111
1111111
1111111
1111111
1111111
1111111
1111111
1111111
1111111
1111111
1111111
1111111
1111111
