NO ./assets/textures/north.png
SO ./assets/textures/south.png
WE ./assets/textures/west.png
EA ./assets/textures/east.png

F 220,100,0,
C 225,30,0

        11111111111 11111111111111
        1000000000110000000000001
        1011000001110000000000001
        1001000000000000000000001
111111111011000001110000000000001
100000000011000001110111111111111
11110111111111011100000010001
11110111111111011101010010001
11000000110101011101110010001
10000000000000000001 100010001
100000000000000011011100000W011
1100000111010101111101111000111
11110111 1110101 101111010001
11111111 1111111 111111111111